Actor1,Actor2,Actor3,Actor4
CHREST, JOE	MONTGOMERY, RITCHIE	SARANDON, SUSAN	JENSEN, DAVID (II)	
GOLDBERG, WHOOPI	DAVID, KEITH (I)	FREEMAN, MORGAN (I)	DE NIRO, ROBERT	
ROCK, CHRIS (I)	DIAZ, CAMERON	COOPER, CHRIS (I)	BOSTON, DAVID (IV)	
BANKS, BOYD	BERGSCHNEIDER, CONRAD	ELDRIDGE, CRAIG	RICHINGS, JULIAN	
DAVID, KEITH (I)	GOLDBERG, WHOOPI	JACKSON, SAMUEL L.	WILLIS, BRUCE	
TUCCI, STANLEY (I)	BLANCHETT, CATE	GLEESON, BRENDAN	MARSAN, EDDIE	
JACKSON, SAMUEL L.	JENKINS, RICHARD (I)	RIEHLE, RICHARD	GARRETT, SPENCER (I)	
PETERS, ROBERT (I)	HOWARD, CLINT	PAPAJOHN, MICHAEL	RIEHLE, RICHARD	
SARANDON, SUSAN	PATRICK, ROBERT (I)	WILLIS, BRUCE	RIEHLE, RICHARD	
STILLER, BEN	SARANDON, SUSAN	RIEHLE, RICHARD	ABERNATHY, DON	
REITZ, RIC	HARRELSON, WOODY	ROGERS, JOEL (I)	WALSH, JOE (XVIII)	
TREJO, DANNY	MCGEE, JACK (I)	CHEUNG, GEORGE	ROSALES JR., THOMAS	
PAPAJOHN, MICHAEL	SARANDON, SUSAN	JACKSON, SAMUEL L.	FREEMAN, MORGAN (I)	
PAPAJOHN, MICHAEL	LEGUIZAMO, JOHN	LEBLANC, ELTON	KEHLER, JACK	
STRONG, MARK (II)	BROADBENT, JIM	IFANS, RHYS	JONES, TOBY (I)	
THOMPSON, DON (I)	HA, BENITA (I)	MCHATTIE, STEPHEN	FOO, COLIN	
SCHWARTZ, SCOTT L.	MADSEN, MICHAEL (I)	THOMERSON, TIM (I)	PAPAJOHN, MICHAEL	
WELKER, FRANK	PAPAJOHN, MICHAEL	DAVID, KEITH (I)	BALDWIN, ALEC	
STILLER, BEN	HARVEY, ROBERT (I)	BUSCEMI, STEVE	ABERNATHY, DON	
JACKSON, SAMUEL L.	RIEHLE, RICHARD	TREJO, DANNY	GOODMAN, JOHN (I)	
